#####################
#@@@@@@@@@@@@@@@@@@@#
#@###@###@#@###@###@#
#@###@###@#@###@###@#
#@@@@@@@@@@@@@@@@@@@#
#@###@####$####@###@#
&@@@@@@@@#$#@@@@@@@@&
#@###@#########@###@#
#@@@@@@@@@@@@@@@@@@@#
#@###@###@#@###@###@#
#@###@###@#@###@###@#
#@@@@@@@@@@@@@@@@@@@#
#####################