 ##################### 
 #                   # 
 # ### ### # ### ### # 
 # ### ### # ### ### # 
 #                   # 
 # ### ####$#### ### # 
 &        #$#        & 
 # ### ######### ### # 
 #                   # 
 # ### ### # ### ### # 
 # ### ### # ### ### # 
 #                   # 
 ##################### 