 #####################
 #◦◦◦◦◦◦◦◦◦◦◦◦◦◦◦◦◦◦◦#
 #◦###◦###◦#◦###◦###◦#
 #◦###◦###◦#◦###◦###◦#
 #◦◦◦◦◦◦◦◦◦◦◦◦◦◦◦◦◦◦◦#
 #◦###◦####$####◦###◦#
 &◦◦◦◦◦◦◦#$$$#◦◦◦◦◦◦◦&
 #◦###◦#########◦###◦#
 #◦◦◦◦◦◦◦◦◦◦◦◦◦◦◦◦◦◦◦#
 #◦###◦###◦#◦###◦###◦#
 #◦###◦###◦#◦###◦###◦#
 #◦◦◦◦◦◦◦◦◦◦◦◦◦◦◦◦◦◦◦#
 #####################